index,threshold,e_count,dash_count,e_frac,dash_frac
1,10,4,6,0.4,0.6
2,20,9,11,0.45,0.55
3,30,14,16,0.466666667,0.533333333
4,40,21,19,0.525,0.475
5,50,25,25,0.5,0.5
6,60,29,31,0.483333333,0.516666667
7,70,36,34,0.514285714,0.485714286
8,80,42,38,0.525,0.475
9,90,46,44,0.511111111,0.488888889
10,100,54,46,0.54,0.46
