index,threshold,e_count,dash_count,e_frac,dash_frac
1,10,5,5,0.5,0.5
2,20,13,7,0.65,0.35
3,30,18,12,0.6,0.4
4,40,26,14,0.65,0.35
5,50,33,17,0.66,0.34
6,60,36,24,0.6,0.4
7,70,40,30,0.571428571,0.428571429
8,80,42,38,0.525,0.475
9,90,48,42,0.533333333,0.466666667
10,100,53,47,0.53,0.47
