index,threshold,e_count,dash_count,e_frac,dash_frac
1,10,10,0,1,0
2,20,20,0,1,0
3,30,29,1,0.966666667,0.033333333
4,40,36,4,0.9,0.1
5,50,42,8,0.84,0.16
6,60,46,14,0.766666667,0.233333333
7,70,54,16,0.771428571,0.228571429
8,80,62,18,0.775,0.225
9,90,70,20,0.777777778,0.222222222
10,100,76,24,0.76,0.24
