index,threshold,e_count,dash_count,e_frac,dash_frac
1,10,7,3,0.7,0.3
2,20,16,4,0.8,0.2
3,30,24,6,0.8,0.2
4,40,31,9,0.775,0.225
5,50,39,11,0.78,0.22
6,60,47,13,0.783333333,0.216666667
7,70,51,19,0.728571429,0.271428571
8,80,58,22,0.725,0.275
9,90,66,24,0.733333333,0.266666667
10,100,72,28,0.72,0.28
