index,threshold,e_count,dash_count,e_frac,dash_frac
1,10,3,7,0.3,0.7
2,20,9,11,0.45,0.55
3,30,14,16,0.466666667,0.533333333
4,40,21,19,0.525,0.475
5,50,28,22,0.56,0.44
6,60,34,26,0.566666667,0.433333333
7,70,42,28,0.6,0.4
8,80,49,31,0.6125,0.3875
9,90,55,35,0.611111111,0.388888889
10,100,65,35,0.65,0.35
