index,threshold,e_count,dash_count,e_frac,dash_frac
1,10,3,7,0.3,0.7
2,20,8,12,0.4,0.6
3,30,15,15,0.5,0.5
4,40,22,18,0.55,0.45
5,50,30,20,0.6,0.4
6,60,37,23,0.616666667,0.383333333
7,70,45,25,0.642857143,0.357142857
8,80,52,28,0.65,0.35
9,90,58,32,0.644444444,0.355555556
10,100,68,32,0.68,0.32
