index,threshold,e_count,dash_count,e_frac,dash_frac
1,10,3,7,0.3,0.7
2,20,10,10,0.5,0.5
3,30,15,15,0.5,0.5
4,40,21,19,0.525,0.475
5,50,26,24,0.52,0.48
6,60,33,27,0.55,0.45
7,70,41,29,0.585714286,0.414285714
8,80,48,32,0.6,0.4
9,90,54,36,0.6,0.4
10,100,64,36,0.64,0.36
