index,threshold,e_count,dash_count,e_frac,dash_frac
1,10,6,4,0.6,0.4
2,20,13,7,0.65,0.35
3,30,19,11,0.633333333,0.366666667
4,40,26,14,0.65,0.35
5,50,35,15,0.7,0.3
6,60,42,18,0.7,0.3
7,70,50,20,0.714285714,0.285714286
8,80,57,23,0.7125,0.2875
9,90,63,27,0.7,0.3
10,100,73,27,0.73,0.27
