index,threshold,e_count,dash_count,e_frac,dash_frac
1,10,8,2,0.8,0.2
2,20,9,11,0.45,0.55
3,30,18,12,0.6,0.4
4,40,23,17,0.575,0.425
5,50,23,27,0.46,0.54
6,60,24,36,0.4,0.6
7,70,34,36,0.485714286,0.514285714
8,80,37,43,0.4625,0.5375
9,90,39,51,0.433333333,0.566666667
10,100,49,51,0.49,0.51
