index,threshold,e_count,dash_count,e_frac,dash_frac
1,10,5,5,0.5,0.5
2,20,12,8,0.6,0.4
3,30,19,11,0.633333333,0.366666667
4,40,26,14,0.65,0.35
5,50,33,17,0.66,0.34
6,60,40,20,0.666666667,0.333333333
7,70,48,22,0.685714286,0.314285714
8,80,55,25,0.6875,0.3125
9,90,61,29,0.677777778,0.322222222
10,100,71,29,0.71,0.29
